{
    "width" : 10,
    "heigth" : 10,
    "gameGrid" : [
    [0,0,0,0,1,0,0,0,0,0],
    [0,0,0,0,0,1,0,0,0,0],
    [0,0,1,1,1,1,1,1,0,0],
    [0,1,1,1,1,1,1,1,1,0],
    [1,1,1,1,1,1,1,0,0,1],
    [1,1,1,1,1,1,1,1,0,1],
    [1,1,1,1,1,1,1,1,1,1],
    [0,1,1,1,1,1,1,1,1,0],
    [0,0,1,1,1,1,1,1,0,0],
    [0,0,0,1,1,1,1,0,0,0]
    ],
    "colorsForFinalGrid" : ["white", "#bf111a", "#a55b30", "#fe755b"],
    "coloredGrid" : [
    [0,0,0,0,2,0,0,0,0,0],
    [0,0,0,0,0,2,0,0,0,0],
    [0,0,1,1,1,2,1,1,0,0],
    [0,1,1,1,1,1,1,1,1,0],
    [1,1,1,1,1,1,1,3,3,1],
    [1,1,1,1,1,1,1,1,3,1],
    [1,1,1,1,1,1,1,1,1,1],
    [0,1,1,1,1,1,1,1,1,0],
    [0,0,1,1,1,1,1,1,0,0],
    [0,0,0,1,1,1,1,0,0,0]
    ]
}