{
    "width" : 10,
    "heigth" : 10,
    "gameGrid" : [
    [0,0,0,0,1,0,0,0,0,0],
    [0,0,0,0,0,1,0,0,0,0],
    [0,0,1,1,1,1,1,1,0,0],
    [0,1,1,1,1,1,1,1,1,0],
    [1,1,1,1,1,1,1,0,0,1],
    [1,1,1,1,1,1,1,1,0,1],
    [1,1,1,1,1,1,1,1,1,1],
    [0,1,1,1,1,1,1,1,1,0],
    [0,0,1,1,1,1,1,1,0,0],
    [0,0,0,1,1,1,1,0,0,0]
    ]
}