{
    "width" : 15,
    "heigth" : 15,
    "gameGrid" : [
    [0,1,0,0,0,0,0,0,0,0,0,0,0,0,0],
    [1,1,1,0,0,0,0,0,0,0,0,0,0,0,0],
    [0,1,0,1,1,1,1,0,0,0,0,0,0,0,0],
    [0,0,0,1,1,1,1,1,0,0,0,0,0,0,0],
    [0,0,1,1,0,1,1,1,1,1,1,0,0,0,0],
    [0,0,1,1,0,0,1,1,1,1,1,1,1,0,0],
    [0,0,1,1,1,1,1,1,1,1,1,1,1,1,0],
    [0,0,0,1,1,1,0,0,0,1,1,1,1,1,1],
    [0,0,0,0,1,1,0,0,0,0,1,1,1,1,1],
    [0,0,0,0,1,1,0,0,0,1,1,1,1,1,1],
    [0,0,0,0,1,1,1,1,1,1,1,1,1,1,1],
    [0,0,0,0,0,1,1,1,1,1,1,1,1,1,1],
    [0,0,0,0,0,0,1,1,1,1,1,1,1,1,0],
    [0,0,0,0,0,0,0,1,1,1,1,1,1,0,0],
    [0,0,0,0,0,0,0,0,1,1,1,1,0,0,0]
    ]
}